009,000,011,010,009,009,010,008,009,009,010,010,009,009,010,010,009,010,010,010,009,009,010,011,009
009,009,017,018,017,017,018,018,017,017,019,017,018,018,017,017,018,018,017,017,017,017,018,009,011
000,008,198,073,074,034,065,065,034,034,034,034,034,034,034,034,034,034,034,034,034,034,207,009,011
008,008,198,087,088,089,048,049,034,037,031,031,031,031,031,032,034,048,049,092,093,094,207,011,011
009,009,198,101,102,103,062,063,034,051,052,052,052,052,052,053,034,062,063,106,107,108,207,011,009
009,008,198,115,116,117,118,063,034,034,034,034,034,034,034,034,034,062,119,120,121,122,207,009,009
000,000,034,129,130,130,132,133,134,134,134,134,134,134,134,134,134,132,133,134,134,136,207,011,009
009,008,034,143,144,145,146,272,201,201,201,201,201,201,201,201,201,271,147,148,149,150,151,011,011
009,009,198,157,158,159,174,119,034,215,216,216,216,216,216,218,065,174,161,162,163,164,165,009,011
010,008,198,171,172,173,174,119,034,229,231,231,231,231,231,232,065,174,175,176,177,178,179,009,009
000,000,198,129,131,131,132,119,034,229,230,230,230,230,230,232,065,174,189,190,191,192,207,011,011
009,009,198,199,200,200,271,119,034,229,230,230,230,230,230,232,065,174,272,205,205,206,207,009,011
009,009,198,073,074,034,090,063,034,270,268,268,268,268,268,267,065,174,119,092,093,094,207,009,009
010,008,198,087,088,089,090,273,131,131,131,131,131,131,131,131,131,132,175,106,107,108,207,011,011
000,000,198,101,102,103,006,272,201,201,201,201,201,201,201,201,201,271,175,120,121,122,207,011,009
009,009,198,115,116,117,062,063,066,219,219,220,220,220,220,220,066,118,273,130,130,136,207,009,011
000,009,198,034,034,034,199,206,034,233,241,233,233,241,233,228,034,199,205,205,205,206,207,011,011
010,008,212,213,213,213,213,213,213,234,233,233,233,241,241,233,219,219,219,219,219,219,213,011,009
009,000,248,009,009,248,248,009,009,009,248,233,248,248,009,009,002,248,248,009,009,248,248,009,009
019,019,016,018,019,017,017,017,018,016,016,016,016,019,019,016,016,016,016,019,019,016,016,016,018

1,1,1,1,1,1,1,1,1,1,1,1,1,1,1,1,1,1,1,1,1,1,1,1,1
1,0,0,0,0,0,0,0,0,0,0,0,0,0,0,0,0,0,0,0,0,0,0,0,1
1,0,0,1,1,0,0,0,0,0,0,0,0,0,0,0,0,0,0,0,0,0,0,0,1
1,0,0,1,1,0,0,0,0,1,1,1,1,1,1,1,0,0,0,0,1,1,0,0,1
1,0,0,0,0,0,0,0,0,0,0,0,0,0,0,0,0,0,0,0,0,0,0,0,1
1,0,0,0,0,0,0,0,0,0,0,0,0,0,0,0,0,0,0,0,0,0,0,0,1
1,0,0,0,0,0,0,0,0,0,0,0,0,0,0,0,0,0,0,0,0,0,0,0,1
1,0,0,0,0,0,0,0,0,0,0,0,0,0,0,0,0,0,0,0,0,1,0,0,1
1,0,0,0,0,0,0,0,0,0,0,0,0,0,0,0,0,0,0,0,0,1,0,0,1
1,0,0,1,1,0,0,0,0,0,0,0,0,0,0,0,0,0,0,0,0,0,0,0,1
1,0,0,0,0,0,0,0,0,0,1,1,1,1,1,0,0,0,0,0,0,0,0,0,1
1,0,0,0,0,0,0,0,0,0,0,0,0,0,0,0,0,0,0,0,0,0,0,0,1
1,0,0,0,0,0,0,0,0,0,0,0,0,0,0,0,0,0,0,0,0,0,0,0,1
1,0,0,1,1,0,0,0,0,0,0,0,0,0,0,0,0,0,0,0,1,1,0,0,1
1,0,0,1,1,0,0,0,0,0,0,0,0,0,0,0,0,0,0,0,0,0,0,0,1
1,0,0,0,0,0,0,0,0,0,0,0,0,0,0,0,0,0,0,0,0,0,0,0,1
1,0,0,0,0,0,0,0,0,0,1,1,1,1,1,0,0,0,0,0,0,0,0,0,1
1,0,0,0,0,0,0,0,0,0,1,0,0,0,1,0,0,0,0,0,0,0,0,0,1
1,0,0,0,0,0,0,0,0,0,1,0,0,0,1,0,0,0,0,0,0,0,0,0,1
1,1,1,1,1,1,1,1,1,1,1,1,1,1,1,1,1,1,1,1,1,1,1,1,1